100000000000000
233000000000000
122110000000000
141242000000000
003243140000000
000041124240000
000000013324100
000000000221342
000000000034141
000000000000121
000000000000001
